_____________________________       ______
|............................|      |....|
|............................|      |....|
|............................|      |....|
|............................|      |....|
|............................|      |....|
|............................|      |....|
|___________________________.............|